1111111111111111
110E00000I000001
1000000C0000C001
10I01000000I0001
100000000P000001
11C0000000000001
11111111111111111