0000000000
0E00000IC0
000C00C000
00I1000P00
0000000000